1111111111111
10P0011110C01
1E00011000001
1111001000111
1C010000101C1
1001110000101
1000000000001
1111111111111