1111111111111111
1CC10000E0001CC1
1C100000000001C1
1000000101000001
10000000P0000001
1C100001010001C1
1CC1000000001CC1
1111111111111111