1111111111111
10P0011110C01
1E00011000001
1111001M00111
1C010000101C1
10M1110000101
1000000000001
1111111111111