11111111111111111111111111111
10000000000000000000000000001
10000000000000000000000000001
10000000000000000000000000001
10010000000011011000010001001
100100000001CC1CC100010001001
100100000001CCCCC100010001001
100100000001CCCCC100010001001
100100000001CCCCC100010001001
100100000001CCCCC100010001001
1001000000001CCC1000010001001
10011111000001010000011111001
10000000000000000000000000001
100PEC00000000000000000000001
11111111111111111111111111111