11111111111111111111111111111
1000000000000MEM0000000000001
1000000000000M0M0000000000001
1000000000000M000000000000001
10010000000011011MMMM10001001
100100000001CC1CC1MMM10001001
100100000001CCCCC1MMM10001001
100100000001CMCCC100010001001
100100000001CCCCC100010001001
100100000001CCCCM100010001001
1001000000001CCC1000010001001
10011111000001010000011111001
10000000000000000000000000001
100P0000000000000000000000001
11111111111111111111111111111