11111111111111111111111111
1000000000001E100000000001
1011101111111P111111110101
1010001000000000000000C101
1010111111111M100111111101
1010000C100000100100000101
10111111101110100101110101
10100000001C10100101010101
101011111M1010111101010101
10100000001000000000010101
10101110101111111111110101
10101010101000000000000101
101110101010M1111111111101
10000C101C1000000000000001
1011111011111111111111M111
100000000000000000000000C1
11111111111111111111111111
