11111111111111111111111111111
1C11M0000000000010001110000C1
101000111110001C101C1010001M1
100010000010011110010M0101011
11111001101111PE1000000000001
10001011000001011110010101011
101011000111010M10101C1110001
10101101011100000000001110111
1C100001M000010000101M10100C1
11111111111111111111111111111