11111111111111111111111111111
1C1100000000000010001110000C1
101000111110001C101C101000101
10001000001001111001000101011
11111001101111PE1000000000001
10001011000001011110010101011
101011000111010010101C1110001
10101101011100000000001110111
1C1000010000010000101010100C1
11111111111111111111111111111