11111111111111111111111111
1000000000001E100000000001
1011101111111P111111110101
10100010000000000000000101
10101111111111100111111101
1010000C100000100100000101
10111111101110100101110101
10100000001C10100101010101
10101111111010111101010101
10100000001000000000010101
10101110101111111111110101
10101010101000000000000101
10111010101001111111111101
10000C101C1000000000000001
10111110111111111111111111
100000000000000000000000C1
11111111111111111111111111
