1111111111111111
1000P00100000001
1111011111110001
1100000001111111
1100000001111001
11111111C0000C01
1110000000000001
111111E111110001
1000000000000001
1000000111111101
1001111110001001
1001C00010000001
1000011111111111
100C000000000001
1111111111111111